5555555555555555555555555555555555555555555555555555555555555555555555555555555555555555555555555555
5555555555555555555555555555555555555555555555555555555555555555555555555555555555555555555555555555
5555555555555555555555555555555555555555555555555555555555555555555555555555555555555555555555555555
5555555555555555555555555555555555555555555555555555555555555555555555555555555555555555555555555555
5555555555555555555555555555555555555555555555555555555555555555555555555555555555555555555555555555
5555555555555555555555555555555555555555555555555555555555555555555555555555555555555555555555555555
5555555555555555555555555555555555555555555555555555555555555555555555555555555555555555555555555555
5555555555555555555555555555555555555555555555555555555555555555555555555555555555555555555555555555
5555555555555555555555555555555555555555555555555555555555555555555555555555555555555555555555555555
5555555555555555555555555555555555555555555555555555555555555555555555555555555555555555555555555555
5555555555555555555555555555555555555555555555555555555555555555555555555555555555555555555555555555
5555555555555555555555555555555555555555555555555555555555555555555555555555555555555555555555555555
5555555555555555555555555555555555555555555555555555555555555555555555555555555555555555555555555555
5555555555555555555555555555555555555555555555555555555555555555555555555555555555555555555555555555
5555555555555555555555555555555555555555555555555555555555555555555555555555555555555555555555555555
5555555555555555555000000000000000l000000000000abbbbbc00000000000000000000000abu55555555555555555555
555555555555555555500gop0r00goop00l00gp0gp0gp00000000000qmmmm90000r000n00000000t55555555555555555555
555555555555555555500tu60l00abb600e00t60t60t6000r000r0r0l000000000l0r0000qop000t55555555555555555555
555555555555555555500tu60l00000l00000ac0ac0ac000tooo60l0l07mmmm900l0l0r00tu6000t55555555555555555555
555555555555555555500abc0e00r07f0000000000000000tbbb60l0l000000000l0l0l00tu6000t55555555555555555555
5555555555555555555000000000l00000r0000000000000e000e0l0dmmmm90000e0l0e00abc000t55555555555555555555
5555555555555555555000000000dm9000e007mmm9000000000000l0000000000000e0000000000a55555555555555555555
555555555555555555507mmm900000000000000000007mmm900n00e007mmm9000000007mmm90000055555555555555555555
55555555555555555550000000000000000000gooop000000000000000000000000000000000000055555555555555555555
5555555555555555555p007mmm900qmmmsoo00abbbc000000000000gop0r00goop000007n900000055555555555555555555
55555555555555555556000000000l000l000000000000000000000tu60l00abb60000n000n0000055555555555555555555
55555555555555555556007mmm900l0r0l0r00000gop0000gp00000tu60l00000l000n00000n000055555555555555555555
55555555555555555556000000000l0l0l0l00000tu60000t600000abc0e00r07f00n0000000n00055555555555555555555
5555555555555555555c007mmm900e0l0l0l00000tu60000t6000000000000l000000000v000000055555555555555555555
5555555555555555555000000000000l000l00000abc0goouuoop000000000dm9000n0000000n00055555555555555555555
5555555555555555555000000000000dmmmf000000000abbuubbc0000000000000000n00000n000055555555555555555555
555555555555555555500000000000000000000000000000t600000000000000000000n000n0000055555555555555555555
55555555555555555550000000000000000gp00000000000t6000000000000gp0000000n0n00000055555555555555555555
55555555555555555550000000000000000t600000000000t6000000000000t6000000000000000055555555555555555555
55555555555555555550000000000000000t600000000000t6000000000000t6000000000000000055555555555555555555
55555555555555555550000000000000goouuoop00000000ac000000000goouuoop000000000000055555555555555555555
55555555555555555550000000000000abbuubbc0000000000000000000abbuubbc000000000000055555555555555555555
55555555555555555550000000000000000t600000r000qms0qms0qm900000t6000000000000000055555555555555555555
55555555555555555550000000000000000t600000l000l0l0l0e0e0000000t6000000000000000055555555555555555555
55555555555555555550000000000000000t600000l000tmf2t9000n000000t6000000000000000055555555555555555555
55555555555555555550000000000000000t600000l000l000e0r000n00000t6000000000000000055555555555555555555
55555555555555555550000000000000000t600000dm90e000e0e079000000t6000000000000000055555555555555555555
55555555555555555550000000000000000ac0000000000000000000000000ac000000000000000055555555555555555555
5555555555555555555000000000000000000000000000000000000000000000000000000000000055555555555555555555
55555555555555555550000000000000000000000000007mmmmmmmmmmmmmmmmmmmmmmmmmmmmmm90055555555555555555555
5555555555555555555000000000000000000000000000000000000000000000000000000000000055555555555555555555
5555555555555555555000000000000000000000000000000000000000000000000000000000000055555555555555555555
5555555555555555555000000000000000000000000000000000000000000000000000000000000055555555555555555555
5555555555555555555000000r0qmmmhmmmhmmms000000000000000000000000000000000000000055555555555555555555
5555555555555555555000000l0l000l000l000l000000000000000000000000000000000000000055555555555555555555
5555555555555555555000000l0l0r0l0r0l0r0l000000000000000000000000000000000000000055555555555555555555
5555555555555555555000000l0l0l0l0l0l0l0l000000000000000000007n90000000000000000055555555555555555555
5555555555555555555000000l0e0l0e0l0e0l0l0000000000000000000n000n000000000000000055555555555555555555
5555555555555555555000000l000l000l000l0l000000000000000000n00000n00000000000000055555555555555555555
5555555555555555555000000immmjmmmjmmmf0l00000000000000000n0v00000r0000000000000055555555555555555555
5555555555555555555000000l0000000000000l000000000000000000000v000l0000000000000055555555555555555555
5555555555555555555p00000l07mmmmmmmmmmmf00000000000000000n0000v00e0000000000000055555555555555555555
5555555555555555555600000l00000000000000000000000000000000n00000n00000000000000055555555555555555555
5555555555555555555600000dmmmmmmmmmmmmm90000000000000000000n000n000000000000000055555555555555555555
555555555555555555560000000000000000000000000000000000000000n0n0000000000000000055555555555555555555
55555555555555555556000000079007900000r0000000000000000000000000000000000000000055555555555555555555
55555555555555555556000000007900790000l0000000000000000000000000000000000000000055555555555555555555
55555555555555555556000000000079000000l0gop000000000000000000000000000000000000055555555555555555555
5555555555555555555uoooop0000000000007jmbbb900000000000000000000000000000000000055555555555555555555
5555555555555555555555555555555555555555555555555555555555555555555555555555555555555555555555555555
5555555555555555555555555555555555555555555555555555555555555555555555555555555555555555555555555555
5555555555555555555555555555555555555555555555555555555555555555555555555555555555555555555555555555
5555555555555555555555555555555555555555555555555555555555555555555555555555555555555555555555555555
5555555555555555555555555555555555555555555555555555555555555555555555555555555555555555555555555555
5555555555555555555555555555555555555555555555555555555555555555555555555555555555555555555555555555
5555555555555555555555555555555555555555555555555555555555555555555555555555555555555555555555555555
5555555555555555555555555555555555555555555555555555555555555555555555555555555555555555555555555555
5555555555555555555555555555555555555555555555555555555555555555555555555555555555555555555555555555
5555555555555555555555555555555555555555555555555555555555555555555555555555555555555555555555555555
5555555555555555555555555555555555555555555555555555555555555555555555555555555555555555555555555555
5555555555555555555555555555555555555555555555555555555555555555555555555555555555555555555555555555
5555555555555555555555555555555555555555555555555555555555555555555555555555555555555555555555555555
5555555555555555555555555555555555555555555555555555555555555555555555555555555555555555555555555555
5555555555555555555555555555555555555555555555555555555555555555555555555555555555555555555555555555
5555555555555555555555555555555555555555555555555555555555555555555555555555555555555555555555555555
